                              
                **            
   *    *       **   *        
  **    **           *        
  *      *           *  *     
  ********      **      *     
  ********      **      *     
                *       *     
  ************  *      **     
  ************  *      **     
   ***          *      *      
   ***          *      *      
        ******  **    **      
        ******  **    **      
        *       ***** ******  
        *       ***** ******  
        *    *        ***  *  
        *    *        ***  *  
             *        ***     
                              