******************************
*               **           *
*  *    *       **   *  *    *
* **    **   *      ***   *  *
* *      *   *       *  *    *
* ********      **      *    *
* ********   *  **      *    *
*               *       *    *
* ************  *      **    *
* ************  *      ****  *
*  ***          *  *** *     *
*  ***          *      *     *
*       ******  **    **     *
*    *  ******  **    **     *
*  *    *       ***** ****** *
*  **** *       ***** ****** *
*     * * *  *        ***  * *
*       *    *        ***  * *
*            *        ***    *
******************************