                              
                **            
   *    *       **   *        
  **    **          ***       
  *      *   *       *  *     
  ********      **      *     
  ********      **      *     
                *       *  *  
  ************  *    * **     
  ************  *  *   **     
   ***          *      *    * 
   ***          *      *      
        ******  **    **      
    *   ******  **    **      
        *       ***** ******  
        *       ***** ******  
      * *    *        ***  *  
   *    *    *        ***  *  
             *        ***     
                              