******************************
*               **           *
*  *    *       **   *       *
* **    **           *       *
* *      *           *  *    *
* ********      **      *    *
* ********      **      *    *
*               *       *    *
* ************  *      **    *
* ************  *      **    *
*  ***          *      *     *
*  ***          *      *     *
*       ******  **    **     *
*       ******  **    **     *
*       *       ***** ****** *
*       *       ***** ****** *
*       *    *        ***  * *
*       *    *        ***  * *
*            *        ***    *
******************************