********************
*       *          *
* * ***** * **** * *
* * *     * **** * *
* * * ** **      * *
* *** ** **** **** *
*          ** ** * *
* * ********   * * *
* *          *** * *
* **** **** **   * *
*    * *     ** ****
* ** * * *** **   **
*    * *        * **
* ** * ******** * **
*       *  *    * **
* * *** **   ** * **
* * ***  * *    *  *
* * * **** * ** ** *
*          *       *
********************