                    
   ***              
     *    ***  ***  
     *         *    
 *****         *    
     *    *******   
     * *    *   *  *
   *   *** **   *  *
   *   *    *      *
*  *   ******     **
*  *   *           *
*  *** *     ***    
*  ***    *  *      
         **  *   *  
**     *****    **  
*  **  *****   **   
*  **  *****  **    
   **          **   
*               **  
**      ***         